#Classification	sample12975_S190_L001_report_bracken_genuses.txt
k__Pseudomonadati	1094
k__Pseudomonadati|p__Pseudomonadota	1091
k__Pseudomonadati|p__Pseudomonadota|c__Gammaproteobacteria	1091
k__Pseudomonadati|p__Pseudomonadota|c__Gammaproteobacteria|o__Lysobacterales	1087
k__Pseudomonadati|p__Pseudomonadota|c__Gammaproteobacteria|o__Lysobacterales|f__Lysobacteraceae	1087
k__Pseudomonadati|p__Pseudomonadota|c__Gammaproteobacteria|o__Lysobacterales|f__Lysobacteraceae|g__Stenotrophomonas	1087
k__Pseudomonadati|p__Pseudomonadota|c__Gammaproteobacteria|o__Pseudomonadales	4
k__Pseudomonadati|p__Pseudomonadota|c__Gammaproteobacteria|o__Pseudomonadales|f__Pseudomonadaceae	4
k__Pseudomonadati|p__Pseudomonadota|c__Gammaproteobacteria|o__Pseudomonadales|f__Pseudomonadaceae|g__Pseudomonas	4
k__Pseudomonadati|p__Bacteroidota	3
k__Pseudomonadati|p__Bacteroidota|c__Chitinophagia	2
k__Pseudomonadati|p__Bacteroidota|c__Chitinophagia|o__Chitinophagales	2
k__Pseudomonadati|p__Bacteroidota|c__Chitinophagia|o__Chitinophagales|f__Chitinophagaceae	2
k__Pseudomonadati|p__Bacteroidota|c__Chitinophagia|o__Chitinophagales|f__Chitinophagaceae|g__Chitinophaga	1
k__Pseudomonadati|p__Bacteroidota|c__Chitinophagia|o__Chitinophagales|f__Chitinophagaceae|g__Rhizosphaericola	1
k__Pseudomonadati|p__Bacteroidota|c__Sphingobacteriia	1
k__Pseudomonadati|p__Bacteroidota|c__Sphingobacteriia|o__Sphingobacteriales	1
k__Pseudomonadati|p__Bacteroidota|c__Sphingobacteriia|o__Sphingobacteriales|f__Sphingobacteriaceae	1
k__Pseudomonadati|p__Bacteroidota|c__Sphingobacteriia|o__Sphingobacteriales|f__Sphingobacteriaceae|g__Pedobacter	1
k__Bacillati	30
k__Bacillati|p__Bacillota	30
k__Bacillati|p__Bacillota|c__Bacilli	30
k__Bacillati|p__Bacillota|c__Bacilli|o__Bacillales	30
k__Bacillati|p__Bacillota|c__Bacilli|o__Bacillales|f__Bacillaceae	30
k__Bacillati|p__Bacillota|c__Bacilli|o__Bacillales|f__Bacillaceae|g__Bacillus	30
