#Classification	sample6618_S143_L001_report_bracken_genuses.txt
k__Pseudomonadati	957
k__Pseudomonadati|p__Pseudomonadota	957
k__Pseudomonadati|p__Pseudomonadota|c__Gammaproteobacteria	956
k__Pseudomonadati|p__Pseudomonadota|c__Gammaproteobacteria|o__Lysobacterales	956
k__Pseudomonadati|p__Pseudomonadota|c__Gammaproteobacteria|o__Lysobacterales|f__Lysobacteraceae	956
k__Pseudomonadati|p__Pseudomonadota|c__Gammaproteobacteria|o__Lysobacterales|f__Lysobacteraceae|g__Stenotrophomonas	956
k__Pseudomonadati|p__Pseudomonadota|c__Betaproteobacteria	1
k__Pseudomonadati|p__Pseudomonadota|c__Betaproteobacteria|o__Burkholderiales	1
k__Pseudomonadati|p__Pseudomonadota|c__Betaproteobacteria|o__Burkholderiales|f__Oxalobacteraceae	1
k__Pseudomonadati|p__Pseudomonadota|c__Betaproteobacteria|o__Burkholderiales|f__Oxalobacteraceae|g__Janthinobacterium	1
k__Bacillati	190
k__Bacillati|p__Bacillota	189
k__Bacillati|p__Bacillota|c__Bacilli	189
k__Bacillati|p__Bacillota|c__Bacilli|o__Bacillales	189
k__Bacillati|p__Bacillota|c__Bacilli|o__Bacillales|f__Bacillaceae	189
k__Bacillati|p__Bacillota|c__Bacilli|o__Bacillales|f__Bacillaceae|g__Bacillus	189
k__Bacillati|p__Actinomycetota	1
k__Bacillati|p__Actinomycetota|c__Actinomycetes	1
k__Bacillati|p__Actinomycetota|c__Actinomycetes|o__Micrococcales	1
k__Bacillati|p__Actinomycetota|c__Actinomycetes|o__Micrococcales|f__Micrococcaceae	1
k__Bacillati|p__Actinomycetota|c__Actinomycetes|o__Micrococcales|f__Micrococcaceae|g__Arthrobacter	1
