#Classification	sample5432_S75_L001_report_bracken_species.txt
k__Pseudomonadati	82
k__Pseudomonadati|p__Pseudomonadota	79
k__Pseudomonadati|p__Pseudomonadota|c__Gammaproteobacteria	79
k__Pseudomonadati|p__Pseudomonadota|c__Gammaproteobacteria|o__Lysobacterales	57
k__Pseudomonadati|p__Pseudomonadota|c__Gammaproteobacteria|o__Lysobacterales|f__Lysobacteraceae	57
k__Pseudomonadati|p__Pseudomonadota|c__Gammaproteobacteria|o__Lysobacterales|f__Lysobacteraceae|g__Stenotrophomonas	57
k__Pseudomonadati|p__Pseudomonadota|c__Gammaproteobacteria|o__Lysobacterales|f__Lysobacteraceae|g__Stenotrophomonas|s__Stenotrophomonas_maltophilia	57
k__Pseudomonadati|p__Pseudomonadota|c__Gammaproteobacteria|o__Pseudomonadales	19
k__Pseudomonadati|p__Pseudomonadota|c__Gammaproteobacteria|o__Pseudomonadales|f__Pseudomonadaceae	19
k__Pseudomonadati|p__Pseudomonadota|c__Gammaproteobacteria|o__Pseudomonadales|f__Pseudomonadaceae|g__Pseudomonas	19
k__Pseudomonadati|p__Pseudomonadota|c__Gammaproteobacteria|o__Pseudomonadales|f__Pseudomonadaceae|g__Pseudomonas|s__Pseudomonas_sp._CIP-10	19
k__Pseudomonadati|p__Pseudomonadota|c__Gammaproteobacteria|o__Enterobacterales	3
k__Pseudomonadati|p__Pseudomonadota|c__Gammaproteobacteria|o__Enterobacterales|f__Enterobacteriaceae	3
k__Pseudomonadati|p__Pseudomonadota|c__Gammaproteobacteria|o__Enterobacterales|f__Enterobacteriaceae|g__Enterobacter	3
k__Pseudomonadati|p__Pseudomonadota|c__Gammaproteobacteria|o__Enterobacterales|f__Enterobacteriaceae|g__Enterobacter|s__Enterobacter_sp._T2	3
k__Pseudomonadati|p__Myxococcota	1
k__Pseudomonadati|p__Myxococcota|o__Nannocystales	1
k__Pseudomonadati|p__Myxococcota|o__Nannocystales|f__Nannocystaceae	1
k__Pseudomonadati|p__Myxococcota|o__Nannocystales|f__Nannocystaceae|g__Nannocystis	1
k__Pseudomonadati|p__Myxococcota|o__Nannocystales|f__Nannocystaceae|g__Nannocystis|s__Nannocystis_punicea	1
k__Pseudomonadati|p__Planctomycetota	1
k__Pseudomonadati|p__Planctomycetota|c__Planctomycetia	1
k__Pseudomonadati|p__Planctomycetota|c__Planctomycetia|o__Planctomycetales	1
k__Pseudomonadati|p__Planctomycetota|c__Planctomycetia|o__Planctomycetales|f__Planctomycetaceae	1
k__Pseudomonadati|p__Planctomycetota|c__Planctomycetia|o__Planctomycetales|f__Planctomycetaceae|g__Planctomyces	1
k__Pseudomonadati|p__Planctomycetota|c__Planctomycetia|o__Planctomycetales|f__Planctomycetaceae|g__Planctomyces|s__Planctomyces_sp._SH-PL14	1
k__Bacillati	4
k__Bacillati|p__Bacillota	4
k__Bacillati|p__Bacillota|c__Bacilli	4
k__Bacillati|p__Bacillota|c__Bacilli|o__Bacillales	4
k__Bacillati|p__Bacillota|c__Bacilli|o__Bacillales|f__Bacillaceae	4
k__Bacillati|p__Bacillota|c__Bacilli|o__Bacillales|f__Bacillaceae|g__Bacillus	4
k__Bacillati|p__Bacillota|c__Bacilli|o__Bacillales|f__Bacillaceae|g__Bacillus|s__Bacillus_cereus	4
