#Classification	sample12974_S189_L001_report_bracken_species.txt
k__Pseudomonadati	611
k__Pseudomonadati|p__Pseudomonadota	610
k__Pseudomonadati|p__Pseudomonadota|c__Gammaproteobacteria	608
k__Pseudomonadati|p__Pseudomonadota|c__Gammaproteobacteria|o__Lysobacterales	605
k__Pseudomonadati|p__Pseudomonadota|c__Gammaproteobacteria|o__Lysobacterales|f__Lysobacteraceae	605
k__Pseudomonadati|p__Pseudomonadota|c__Gammaproteobacteria|o__Lysobacterales|f__Lysobacteraceae|g__Stenotrophomonas	605
k__Pseudomonadati|p__Pseudomonadota|c__Gammaproteobacteria|o__Lysobacterales|f__Lysobacteraceae|g__Stenotrophomonas|s__Stenotrophomonas_maltophilia	605
k__Pseudomonadati|p__Pseudomonadota|c__Gammaproteobacteria|o__Enterobacterales	2
k__Pseudomonadati|p__Pseudomonadota|c__Gammaproteobacteria|o__Enterobacterales|f__Bruguierivoracaceae	2
k__Pseudomonadati|p__Pseudomonadota|c__Gammaproteobacteria|o__Enterobacterales|f__Bruguierivoracaceae|g__Sodalis	2
k__Pseudomonadati|p__Pseudomonadota|c__Gammaproteobacteria|o__Enterobacterales|f__Bruguierivoracaceae|g__Sodalis|s__Sodalis_ligni	2
k__Pseudomonadati|p__Pseudomonadota|c__Gammaproteobacteria|o__Acidiferrobacterales	1
k__Pseudomonadati|p__Pseudomonadota|c__Gammaproteobacteria|o__Acidiferrobacterales|f__Acidiferrobacteraceae	1
k__Pseudomonadati|p__Pseudomonadota|c__Gammaproteobacteria|o__Acidiferrobacterales|f__Acidiferrobacteraceae|g__Sulfurifustis	1
k__Pseudomonadati|p__Pseudomonadota|c__Gammaproteobacteria|o__Acidiferrobacterales|f__Acidiferrobacteraceae|g__Sulfurifustis|s__Sulfurifustis_variabilis	1
k__Pseudomonadati|p__Pseudomonadota|c__Alphaproteobacteria	2
k__Pseudomonadati|p__Pseudomonadota|c__Alphaproteobacteria|o__Sphingomonadales	2
k__Pseudomonadati|p__Pseudomonadota|c__Alphaproteobacteria|o__Sphingomonadales|f__Sphingomonadaceae	2
k__Pseudomonadati|p__Pseudomonadota|c__Alphaproteobacteria|o__Sphingomonadales|f__Sphingomonadaceae|g__Sphingomonas	2
k__Pseudomonadati|p__Pseudomonadota|c__Alphaproteobacteria|o__Sphingomonadales|f__Sphingomonadaceae|g__Sphingomonas|s__Sphingomonas_morindae	2
k__Pseudomonadati|p__Myxococcota	1
k__Pseudomonadati|p__Myxococcota|o__Haliangiales	1
k__Pseudomonadati|p__Myxococcota|o__Haliangiales|f__Kofleriaceae	1
k__Pseudomonadati|p__Myxococcota|o__Haliangiales|f__Kofleriaceae|g__Haliangium	1
k__Pseudomonadati|p__Myxococcota|o__Haliangiales|f__Kofleriaceae|g__Haliangium|s__Haliangium_ochraceum	1
k__Bacillati	73
k__Bacillati|p__Bacillota	73
k__Bacillati|p__Bacillota|c__Bacilli	73
k__Bacillati|p__Bacillota|c__Bacilli|o__Bacillales	73
k__Bacillati|p__Bacillota|c__Bacilli|o__Bacillales|f__Bacillaceae	73
k__Bacillati|p__Bacillota|c__Bacilli|o__Bacillales|f__Bacillaceae|g__Bacillus	73
k__Bacillati|p__Bacillota|c__Bacilli|o__Bacillales|f__Bacillaceae|g__Bacillus|s__Bacillus_cereus	73
