#Classification	sample12973_S188_L001_report_bracken_species.txt
k__Pseudomonadati	314
k__Pseudomonadati|p__Pseudomonadota	313
k__Pseudomonadati|p__Pseudomonadota|c__Gammaproteobacteria	313
k__Pseudomonadati|p__Pseudomonadota|c__Gammaproteobacteria|o__Lysobacterales	307
k__Pseudomonadati|p__Pseudomonadota|c__Gammaproteobacteria|o__Lysobacterales|f__Lysobacteraceae	307
k__Pseudomonadati|p__Pseudomonadota|c__Gammaproteobacteria|o__Lysobacterales|f__Lysobacteraceae|g__Stenotrophomonas	307
k__Pseudomonadati|p__Pseudomonadota|c__Gammaproteobacteria|o__Lysobacterales|f__Lysobacteraceae|g__Stenotrophomonas|s__Stenotrophomonas_maltophilia	307
k__Pseudomonadati|p__Pseudomonadota|c__Gammaproteobacteria|o__Pseudomonadales	6
k__Pseudomonadati|p__Pseudomonadota|c__Gammaproteobacteria|o__Pseudomonadales|f__Pseudomonadaceae	6
k__Pseudomonadati|p__Pseudomonadota|c__Gammaproteobacteria|o__Pseudomonadales|f__Pseudomonadaceae|g__Pseudomonas	6
k__Pseudomonadati|p__Pseudomonadota|c__Gammaproteobacteria|o__Pseudomonadales|f__Pseudomonadaceae|g__Pseudomonas|s__Pseudomonas_sp._CIP-10	6
k__Pseudomonadati|p__Bacteroidota	1
k__Pseudomonadati|p__Bacteroidota|c__Chitinophagia	1
k__Pseudomonadati|p__Bacteroidota|c__Chitinophagia|o__Chitinophagales	1
k__Pseudomonadati|p__Bacteroidota|c__Chitinophagia|o__Chitinophagales|f__Chitinophagaceae	1
k__Pseudomonadati|p__Bacteroidota|c__Chitinophagia|o__Chitinophagales|f__Chitinophagaceae|g__Chitinophaga	1
k__Pseudomonadati|p__Bacteroidota|c__Chitinophagia|o__Chitinophagales|f__Chitinophagaceae|g__Chitinophaga|s__Chitinophaga_sp._MM2321	1
k__Bacillati	7
k__Bacillati|p__Actinomycetota	4
k__Bacillati|p__Actinomycetota|c__Actinomycetes	4
k__Bacillati|p__Actinomycetota|c__Actinomycetes|o__Kitasatosporales	4
k__Bacillati|p__Actinomycetota|c__Actinomycetes|o__Kitasatosporales|f__Streptomycetaceae	4
k__Bacillati|p__Actinomycetota|c__Actinomycetes|o__Kitasatosporales|f__Streptomycetaceae|g__Streptomyces	4
k__Bacillati|p__Actinomycetota|c__Actinomycetes|o__Kitasatosporales|f__Streptomycetaceae|g__Streptomyces|s__Streptomyces_chromofuscus	4
k__Bacillati|p__Bacillota	3
k__Bacillati|p__Bacillota|c__Bacilli	3
k__Bacillati|p__Bacillota|c__Bacilli|o__Bacillales	2
k__Bacillati|p__Bacillota|c__Bacilli|o__Bacillales|f__Bacillaceae	2
k__Bacillati|p__Bacillota|c__Bacilli|o__Bacillales|f__Bacillaceae|g__Bacillus	2
k__Bacillati|p__Bacillota|c__Bacilli|o__Bacillales|f__Bacillaceae|g__Bacillus|s__Bacillus_cereus	2
k__Bacillati|p__Bacillota|c__Bacilli|o__Lactobacillales	1
k__Bacillati|p__Bacillota|c__Bacilli|o__Lactobacillales|f__Enterococcaceae	1
k__Bacillati|p__Bacillota|c__Bacilli|o__Lactobacillales|f__Enterococcaceae|g__Enterococcus	1
k__Bacillati|p__Bacillota|c__Bacilli|o__Lactobacillales|f__Enterococcaceae|g__Enterococcus|s__Enterococcus_faecalis	1
