#Classification	sample6617_S142_L001_report_bracken_species.txt
k__Pseudomonadati	859
k__Pseudomonadati|p__Pseudomonadota	859
k__Pseudomonadati|p__Pseudomonadota|c__Gammaproteobacteria	858
k__Pseudomonadati|p__Pseudomonadota|c__Gammaproteobacteria|o__Lysobacterales	858
k__Pseudomonadati|p__Pseudomonadota|c__Gammaproteobacteria|o__Lysobacterales|f__Lysobacteraceae	858
k__Pseudomonadati|p__Pseudomonadota|c__Gammaproteobacteria|o__Lysobacterales|f__Lysobacteraceae|g__Stenotrophomonas	858
k__Pseudomonadati|p__Pseudomonadota|c__Gammaproteobacteria|o__Lysobacterales|f__Lysobacteraceae|g__Stenotrophomonas|s__Stenotrophomonas_maltophilia	858
k__Pseudomonadati|p__Pseudomonadota|c__Betaproteobacteria	1
k__Pseudomonadati|p__Pseudomonadota|c__Betaproteobacteria|o__Burkholderiales	1
k__Pseudomonadati|p__Pseudomonadota|c__Betaproteobacteria|o__Burkholderiales|f__Burkholderiaceae	1
k__Pseudomonadati|p__Pseudomonadota|c__Betaproteobacteria|o__Burkholderiales|f__Burkholderiaceae|g__Paraburkholderia	1
k__Pseudomonadati|p__Pseudomonadota|c__Betaproteobacteria|o__Burkholderiales|f__Burkholderiaceae|g__Paraburkholderia|s__Paraburkholderia_tropica	1
k__Bacillati	7
k__Bacillati|p__Bacillota	7
k__Bacillati|p__Bacillota|c__Bacilli	7
k__Bacillati|p__Bacillota|c__Bacilli|o__Bacillales	7
k__Bacillati|p__Bacillota|c__Bacilli|o__Bacillales|f__Bacillaceae	7
k__Bacillati|p__Bacillota|c__Bacilli|o__Bacillales|f__Bacillaceae|g__Bacillus	7
k__Bacillati|p__Bacillota|c__Bacilli|o__Bacillales|f__Bacillaceae|g__Bacillus|s__Bacillus_cereus	7
